académie	NOUN
accompagner	VERB
agressivité	NOUN
américain	ADJ
anonymat	NOUN
appeler	VERB
autorité	NOUN
beaucoup	ADV
blessure	NOUN
bonheur	NOUN
britannique	NOUN
certainement	ADV
cicatrice	NOUN
circulation	NOUN
civique	ADJ
comporte	VERB
consommation	NOUN
contexte	NOUN
controverser	VERB
disparaître	VERB
divertissement	ADJ
doubler	VERB
déclaration	NOUN
décontracter	VERB
définitif	ADJ
déléguer	VERB
développement	NOUN
engager	VERB
enregistrer	VERB
ensuite	ADV
environ	NOUN
exemple	NOUN
exorbitant	ADJ
expérimentation	NOUN
figurer	VERB
financement	NOUN
fouiller	VERB
galerie	NOUN
gouvernement	NOUN
gratuit	NOUN
illuminer	VERB
imaginer	VERB
imposer	VERB
inattendu	ADJ
inscription	NOUN
instant	NOUN
juridique	ADJ
liaison	NOUN
londonien	ADJ
magazine	NOUN
manifeste	ADJ
maximum	NOUN
morceau	NOUN
musicien	NOUN
naturel	VERB
nettement	ADV
nouvellement	ADV
nécessaire	ADJ
négatif	ADJ
olympique	ADJ
orchestre	VERB
parallèle	NOUN
paramètre	NOUN
persister	VERB
personnalité	NOUN
personnel	NOUN
possession	NOUN
potentiel	NOUN
pouvoir	NOUN
principalement	ADV
procédé	NOUN
prolongement	NOUN
précisément	ADV
rassemblement	NOUN
recours	NOUN
rendement	NOUN
repenser	VERB
réaction	NOUN
réalisateur	NOUN
réfléchir	VERB
référence	NOUN
répondre	VERB
répéter	VERB
scolaire	ADJ
solliciter	VERB
sonorité	NOUN
souffrance	NOUN
souligner	VERB
supplémentaire	ADJ
symbole	NOUN
tragique	ADJ
traitement	NOUN
transformer	VERB
trottoir	NOUN
universitaire	ADJ
urgence	NOUN
échouer	VERB
éclater	VERB
économie	NOUN
étranger	ADJ
